################################
#..............................#
#..###....####....####....###..#
#..#.........#....#.........#..#
#......###............###......#
#..#...#.....##..##.....#...#..#
#......####..##..##..####......#
#............##..##............#
#............##..##............#
#......####..##..##..####......#
#..#...#.....##..##.....#...#..#
#......###............###......#
#..#.........#....#.........#..#
#..###....####....####....###..#
#..............................#
################################